4,4,7,0,0,7,4,4,4,4
7,7,7,0,0,7,7,7,7,7
7,7,7,0,0,7,7,7,7,7
7,7,7,0,0,7,7,7,7,7
7,7,7,0,0,7,7,7,7,7
7,7,7,0,0,7,7,7,7,7
7,7,7,0,0,7,7,7,7,7
7,7,7,0,0,7,7,7,7,7
7,7,7,0,0,7,7,7,7,7
7,7,7,0,0,7,7,7,7,7
7,7,7,0,0,7,7,7,7,7
7,7,7,0,0,7,7,7,7,7
7,7,7,0,0,7,7,7,7,7
7,7,7,0,0,7,7,7,7,7
7,7,7,0,0,7,7,7,7,7
7,7,7,0,0,7,7,7,7,7
7,7,7,0,0,7,7,7,7,7
7,7,7,0,0,7,7,7,7,7
7,7,7,0,0,7,7,7,7,7
7,7,7,0,0,7,7,7,7,7
7,7,7,0,0,7,7,7,7,7
7,7,7,0,0,7,7,7,7,7
7,7,7,0,0,7,7,7,7,7
7,7,7,0,0,7,7,7,7,7
7,7,7,0,0,7,7,7,7,7
7,7,7,0,0,7,7,7,7,7
7,7,7,0,0,7,7,7,7,7
7,7,7,0,0,7,7,7,7,7
7,7,7,0,0,7,7,7,7,7
7,7,7,0,0,7,7,7,7,7
7,7,7,0,0,7,7,7,7,7
7,7,7,0,0,7,7,7,7,7
7,7,7,0,0,7,7,7,7,7
7,7,7,0,0,7,7,7,7,7
7,7,7,0,0,7,7,7,7,7
7,7,7,0,0,7,7,7,7,7
7,7,7,0,0,7,7,7,7,7
7,7,7,0,0,7,7,7,7,7
7,7,7,0,0,7,7,7,7,7
7,7,7,0,0,7,7,7,7,7
7,7,7,0,0,7,7,7,7,7
7,7,7,0,0,7,7,7,7,7
7,7,7,0,0,7,7,7,7,7
7,7,7,0,0,7,7,7,7,7
7,7,7,0,0,7,7,7,7,7
7,7,7,0,0,7,7,7,7,7
7,7,7,0,0,7,7,7,7,7
7,7,7,0,0,7,7,7,7,7
7,7,7,0,0,7,7,7,7,7
7,7,7,0,0,7,7,7,7,7
7,7,7,0,0,7,7,7,7,7
7,7,7,0,0,7,7,7,7,7
7,7,7,0,0,7,7,7,7,7
7,7,7,0,0,7,7,7,7,7
7,7,7,0,0,7,7,7,7,7
7,7,7,0,0,7,7,7,7,7
7,7,7,0,0,7,7,7,7,7
7,7,7,0,0,7,7,7,7,7
7,7,7,0,0,7,7,7,7,7
7,7,7,0,0,7,7,7,7,7
7,7,7,0,0,7,7,7,7,7
7,7,7,0,0,7,7,7,7,7
7,7,7,0,0,7,7,7,7,7
7,7,7,0,0,7,7,7,7,7
7,7,7,0,0,7,7,7,7,7
7,7,7,0,0,7,7,7,7,7
7,7,7,0,0,7,7,7,7,7
7,7,7,0,0,7,7,7,7,7
7,7,7,0,0,7,7,7,7,7
7,7,7,0,0,7,7,7,7,7
7,7,7,0,0,7,7,7,7,7
7,7,7,0,0,7,7,7,7,7
7,7,7,0,0,7,7,7,7,7
7,7,7,0,0,7,7,7,7,7
7,7,7,0,0,7,7,7,7,7
7,7,7,0,0,7,7,7,7,7
7,7,7,0,0,7,7,7,7,7
7,7,7,0,0,7,7,7,7,7
7,7,7,0,0,7,7,7,7,7
7,7,7,0,0,7,7,7,7,7
7,7,7,0,0,7,7,7,7,7
7,7,7,0,0,7,7,7,7,7
7,7,7,0,0,7,7,7,7,7
7,7,7,0,0,7,7,7,7,7
7,7,7,0,0,7,7,7,7,7
7,7,7,0,0,7,7,7,7,7
7,7,7,0,0,7,7,7,7,7
7,7,7,0,0,7,7,7,7,7
7,7,7,0,0,7,7,7,7,7
7,7,7,0,0,7,7,7,7,7
7,7,7,0,0,7,7,7,7,7
7,7,7,0,0,7,7,7,7,7
7,7,7,0,0,7,7,7,7,7
7,7,7,0,0,7,7,7,7,7
7,7,7,0,0,7,7,7,7,7
7,7,7,0,0,7,7,7,7,7
7,7,7,0,0,7,7,7,7,7
7,7,7,0,0,7,7,7,7,7
7,7,7,0,0,7,7,7,7,7
7,7,7,0,0,7,7,7,7,7
7,7,7,0,0,7,7,7,7,7
7,7,7,0,0,7,7,7,7,7
7,7,7,0,0,7,7,7,7,7
7,7,7,0,0,7,7,7,7,7
7,7,7,0,0,7,7,7,7,7
7,7,7,0,0,7,7,7,7,7
7,7,7,0,0,7,7,7,7,7
7,7,7,0,0,7,7,7,7,7
7,7,7,0,0,7,7,7,7,7
7,7,7,0,0,7,7,7,7,7
7,7,7,0,0,7,7,7,7,7
7,7,7,0,0,7,7,7,7,7
7,7,7,0,0,7,7,7,7,7
7,7,7,0,0,7,7,7,7,7
7,7,7,0,0,7,7,7,7,7
7,7,7,0,0,7,7,7,7,7
7,7,7,0,0,7,7,7,7,7
7,7,7,0,0,7,7,7,7,7
7,7,7,0,0,7,7,7,7,7
7,7,7,0,0,7,7,7,7,7
7,7,7,0,0,7,7,7,7,7
7,7,7,0,0,7,7,7,7,7
7,7,7,0,0,7,7,7,7,7
7,7,7,0,0,7,7,7,7,7
7,7,7,0,0,7,7,7,7,7
7,7,7,0,0,7,7,7,7,7
7,7,7,0,0,7,7,7,7,7
7,7,7,0,0,7,7,7,7,7
7,7,7,0,0,7,7,7,7,7
7,7,7,0,0,7,7,7,7,7
7,7,7,0,0,7,7,7,7,7
7,7,7,0,0,7,7,7,7,7
7,7,7,0,0,7,7,7,7,7
7,7,7,0,0,7,7,7,7,7
7,7,7,0,0,7,7,7,7,7
7,7,7,0,0,7,7,7,7,7
7,7,7,0,0,7,7,7,7,7
7,7,7,0,0,7,7,7,7,7
7,7,7,0,0,7,7,7,7,7
7,7,7,0,0,7,7,7,7,7
7,7,7,0,0,7,7,7,7,7
7,7,7,0,0,7,7,7,7,7
7,7,7,0,0,7,7,7,7,7
7,7,7,0,0,7,7,7,7,7
7,7,7,0,0,7,7,7,7,7
7,7,7,0,0,7,7,7,7,7
7,7,7,0,0,7,7,7,7,7
7,7,7,0,0,7,7,7,7,7
7,7,7,0,0,7,7,7,7,7
7,7,7,0,0,7,7,7,7,7
7,7,7,0,0,7,7,7,7,7
7,7,7,0,0,7,7,7,7,7
7,7,7,0,0,7,7,7,7,7
7,7,7,0,0,7,7,7,7,7
7,7,7,0,0,7,7,7,7,7
7,7,7,0,0,7,7,7,7,7
7,7,7,0,0,7,7,7,7,7
7,7,7,0,0,7,7,7,7,7
7,7,7,0,0,7,7,7,7,7
7,7,7,0,0,7,7,7,7,7
7,7,7,0,0,7,7,7,7,7
7,7,7,0,0,7,7,7,7,7
7,7,7,0,0,7,7,7,7,7
7,7,7,0,0,7,7,7,7,7
7,7,7,0,0,7,7,7,7,7
7,7,7,0,0,7,7,7,7,7
7,7,7,0,0,7,7,7,7,7
7,7,7,0,0,7,7,7,7,7
7,7,7,0,0,7,7,7,7,7
7,7,7,0,0,7,7,7,7,7
7,7,7,0,0,7,7,7,7,7
7,7,7,0,0,7,7,7,7,7
7,7,7,0,0,7,7,7,7,7
7,7,7,0,0,7,7,7,7,7
7,7,7,0,0,7,7,7,7,7
7,7,7,0,0,7,7,7,7,7
7,7,7,0,0,7,7,7,7,7
7,7,7,0,0,7,7,7,7,7
7,7,7,0,0,7,7,7,7,7
7,7,7,0,0,7,7,7,7,7
7,7,7,0,0,7,7,7,7,7
7,7,7,0,0,7,7,7,7,7
7,7,7,0,0,7,7,7,7,7
7,7,7,0,0,7,7,7,7,7
7,7,7,0,0,7,7,7,7,7
7,7,7,0,0,7,7,7,7,7
7,7,7,0,0,7,7,7,7,7
7,7,7,0,0,7,7,7,7,7
7,7,7,0,0,7,7,7,7,7
7,7,7,0,0,7,7,7,7,7
7,7,7,0,0,7,7,7,7,7
7,7,7,0,0,7,7,7,7,7
7,7,7,0,0,7,7,7,7,7
7,7,7,0,0,7,7,7,7,7
7,7,7,0,0,7,7,7,7,7
7,7,7,0,0,7,7,7,7,7
7,7,7,0,0,7,7,7,7,7
7,7,7,0,0,7,7,7,7,7
7,7,7,0,0,7,7,7,7,7
7,7,7,0,0,7,7,7,7,7
7,7,7,0,0,7,7,7,7,7
7,7,7,0,0,7,7,7,7,7
7,7,7,0,0,7,7,7,7,7
7,7,7,0,0,7,7,7,7,7
7,7,7,0,0,7,7,7,7,7
7,7,7,0,0,7,7,7,7,7
7,7,7,0,0,7,7,7,7,7
7,7,7,0,0,7,7,7,7,7
7,7,7,0,0,7,7,7,7,7
7,7,7,0,0,7,7,7,7,7
7,7,7,0,0,7,7,7,7,7
7,7,7,0,0,7,7,7,7,7
7,7,7,0,0,7,7,7,7,7
7,7,7,0,0,7,7,7,7,7
7,7,7,0,0,7,7,7,7,7
7,7,7,0,0,7,7,7,7,7
7,7,7,0,0,7,7,7,7,7
7,7,7,0,0,7,7,7,7,7
7,7,7,0,0,7,7,7,7,7
7,7,7,0,0,7,7,7,7,7
7,7,7,0,0,7,7,7,7,7
7,7,7,0,0,7,7,7,7,7
7,7,7,0,0,7,7,7,7,7
7,7,7,0,0,7,7,7,7,7
7,7,7,0,0,7,7,7,7,7
7,7,7,0,0,7,7,7,7,7
7,7,7,0,0,7,7,7,7,7
0,0,0,0,0,0,0,0,0,0
0,0,0,0,7,7,0,0,7,7
0,7,7,0,0,7,0,7,0,7
0,0,7,0,7,0,0,7,7,0
0,7,7,0,7,0,0,7,0,7
0,0,0,0,7,7,0,0,7,7
0,0,0,0,0,0,0,0,0,0
7,7,7,7,7,7,7,7,7,7
7,7,7,7,7,7,7,7,7,7
7,7,7,7,7,7,7,7,7,7
7,7,7,7,7,7,7,7,7,7
7,7,7,7,7,4,7,7,7,7
7,7,7,7,4,4,4,7,7,7
7,7,7,7,5,5,5,7,7,7
5,5,5,5,5,5,5,7,7,7
5,5,5,5,5,5,5,5,7,5
5,5,5,5,5,5,5,7,7,7
5,5,5,1,5,5,5,7,7,7
5,5,5,4,5,5,5,7,7,7
5,5,5,5,5,5,5,7,7,7
5,5,5,5,5,5,5,7,7,7
5,5,5,5,5,5,5,5,5,5
5,5,5,5,5,5,5,7,7,7
5,5,5,5,5,0,5,7,7,7
5,5,5,5,5,5,5,7,7,7
5,5,5,5,5,5,5,7,7,7
5,5,5,5,5,5,5,5,5,5
5,5,5,5,5,5,5,7,7,7
5,5,5,5,5,5,5,7,7,7
5,5,5,5,5,5,5,7,7,7
5,5,5,5,5,5,5,5,5,5
5,5,5,5,5,5,5,5,1,5
7,7,7,7,7,7,7,5,5,5
7,7,7,7,7,7,7,7,0,7
7,7,7,7,7,7,7,5,5,4
7,7,7,5,5,5,5,5,5,7
7,7,7,5,5,5,5,0,5,7
7,7,7,5,5,5,5,5,5,7
7,7,7,7,7,7,7,7,7,7
7,7,7,4,4,4,4,4,4,7
0,7,7,5,5,5,5,5,5,0
0,7,7,5,5,5,5,5,5,7
7,7,7,5,5,5,5,5,5,7
7,7,7,7,7,7,7,7,7,7
7,7,7,7,7,7,7,7,7,0
7,7,7,7,7,7,7,7,7,7
7,7,7,7,7,7,7,7,7,7
7,7,7,7,7,7,7,7,7,7
7,7,7,7,0,7,7,7,7,7
5,5,5,5,5,5,5,5,5,5
5,5,5,5,5,5,5,5,5,0
5,5,5,5,5,5,5,5,5,5
5,5,5,5,5,5,5,5,5,5
5,5,5,5,5,5,5,5,5,5
5,5,5,5,5,5,5,5,5,5
5,5,5,5,5,5,5,5,5,5
5,5,5,5,5,5,5,5,5,5
5,5,5,5,5,5,5,5,5,5
5,5,5,5,5,5,5,5,5,5
5,5,5,5,5,5,5,5,5,5
7,7,7,7,7,7,7,7,7,7
7,7,7,7,7,7,7,7,7,7
7,7,7,7,7,7,7,7,7,7
7,7,7,7,7,7,7,7,7,7
7,7,7,7,7,7,7,7,7,7
7,7,7,7,7,7,7,7,7,7
7,7,7,7,7,7,7,7,7,7
7,7,7,7,1,7,7,7,7,7
7,7,7,7,7,7,7,7,7,7
7,7,7,7,7,7,7,7,7,7
7,7,7,7,7,7,7,7,7,7
6,7,0,7,7,7,7,7,7,6
6,7,0,7,7,7,7,7,7,6
6,7,7,7,7,7,7,7,7,6
6,7,7,7,7,7,7,7,7,6
6,7,7,7,7,7,7,7,7,6
6,7,7,7,7,7,7,7,7,6
6,7,7,7,7,7,7,7,7,6
6,7,7,7,7,7,7,7,7,6
6,7,7,7,7,7,7,7,7,6
7,7,7,7,7,7,7,7,7,7
7,7,7,7,7,7,7,7,7,7
7,7,7,7,7,7,7,0,7,7
7,7,7,7,7,7,7,7,7,7
7,7,7,7,7,7,7,7,7,7
7,7,7,7,7,7,7,7,7,7
7,7,7,7,7,0,7,7,7,7
7,7,7,7,7,7,7,7,7,7
7,7,7,7,7,7,7,7,7,7
7,7,7,7,7,7,7,7,7,7
4,4,4,4,4,4,4,4,7,7
7,7,7,7,7,7,7,4,7,7
7,7,7,7,7,7,7,4,0,7
7,7,7,7,7,7,7,4,7,7
7,7,3,3,3,7,7,4,7,7
7,3,4,7,4,3,7,4,7,7
7,3,7,7,7,3,7,4,7,7
7,3,4,4,4,3,7,4,7,7
7,3,4,7,4,3,7,4,7,7
7,7,3,3,3,7,7,4,7,0
7,7,7,7,7,7,7,4,7,7
7,7,7,7,7,7,7,4,7,7
7,7,7,7,7,7,7,4,7,7
7,7,7,7,7,7,7,4,7,7
7,4,4,7,7,7,7,4,7,7
7,4,7,4,7,7,7,4,7,7
7,4,7,4,0,0,0,4,0,0
7,4,7,7,4,0,4,7,0,0
7,4,7,7,7,4,7,0,0,0
7,4,7,7,7,7,7,0,0,0
7,4,7,7,7,7,0,0,0,0
7,4,7,7,7,7,0,0,0,7
7,4,7,7,7,0,0,0,7,7
7,4,7,7,7,0,0,0,7,7
7,4,7,7,0,0,0,7,7,7
7,4,7,0,0,0,0,7,7,7
7,4,7,0,0,0,7,7,7,7
7,4,7,0,0,0,7,7,7,7
7,4,7,0,0,0,7,7,7,7
7,4,7,0,0,7,7,7,7,7
7,4,7,0,0,7,7,7,7,7
7,4,7,0,0,7,7,7,7,7
7,4,7,0,0,7,7,7,7,7
7,4,7,7,0,0,7,7,7,7
7,4,7,7,0,0,0,7,7,7
7,4,4,7,7,0,0,7,7,7
7,7,4,7,7,0,0,0,7,7
1,7,4,7,7,7,0,0,7,7
7,7,4,7,7,7,0,0,7,7
7,7,4,7,7,7,7,0,0,7
7,7,4,7,7,7,7,7,0,0
7,7,4,7,7,7,7,7,0,0
7,7,4,7,7,7,7,7,0,0
7,7,4,7,7,7,7,7,0,0
7,7,7,4,7,7,7,7,0,0
7,0,7,4,7,7,7,7,0,0
7,7,7,4,7,7,7,7,0,0
7,7,7,4,7,7,7,7,0,0
7,7,7,4,7,7,7,7,0,0
7,7,7,4,7,7,7,7,0,0
7,0,7,4,7,7,7,7,0,0
7,7,7,4,7,7,7,7,0,0
7,7,7,4,7,7,7,7,0,0
7,7,7,7,4,7,7,7,0,0
7,7,0,7,4,7,7,7,0,0
7,7,7,7,4,7,7,7,0,0
7,7,7,7,4,7,7,7,0,0
7,7,7,7,4,7,7,0,0,0
4,7,0,7,4,7,0,0,0,7
4,7,7,7,4,7,0,0,7,7
4,7,7,7,4,7,0,0,7,7
4,7,7,7,4,7,0,0,7,7
6,7,7,7,7,4,7,7,7,6
6,7,7,0,7,4,7,7,7,6
6,7,7,7,7,4,7,7,7,6
6,7,7,7,7,4,7,7,7,6
6,7,7,7,7,4,7,7,0,6
6,7,7,0,7,4,7,7,7,6
6,7,7,7,7,4,7,7,7,6
6,7,7,7,7,4,7,7,7,6
4,7,7,7,7,4,7,7,7,7
4,7,7,7,7,7,4,7,7,7
4,4,7,7,7,7,4,7,7,7
4,4,7,7,0,7,4,7,7,7
4,4,7,7,0,7,4,7,7,7
4,4,7,7,7,7,4,7,7,7
4,4,7,7,7,7,4,7,7,7
4,4,7,7,0,0,4,7,7,7
4,4,7,7,7,7,4,7,7,7
4,4,7,7,7,7,4,4,4,4
4,4,7,7,7,7,4,4,4,4
4,4,4,7,7,7,4,4,4,4
4,4,4,4,7,7,4,4,4,4